####################################S###########################################
a                   #               N                                          #
#    ........... X  #                                                          #
#    ...........    #                                                          #
S    ...........    #                                                          #
#    ........... 1  #                                                          #
#    ........... X  #                                                          #
#    ...........    #                                            2             #
#   #################                                                          #
#                   #                                                          #
#                   #                                                          #
#                   #                                    N                     #
#                   #   ...........                                            #
#################   #   ...........                                            #
#                   #   ...........                                            #
#                   #   ...........                                            #
#                   #   ...........                                            #
#                   #   ...........                                            #
#                   #   ...........                                            #
#                   #                                                          #
#                   #                                                          #
#                   #                                                          #
#                   #                                                          #
#                           .......................................            #
#                           .......................................            #
#           0               .......................................            #
#                                                                              #
###############################            #####################################
#             X               B            b                                   #
#                             B            b            3                      #
#                             B            b                                   #
#                  N          B            b                                   #
#                             B            b                                   #
#                             B            b                                   #
#                             B            b                      N            #
#                             B            b                                   #
#                           X B            b                                   #
###############################            #####################################
#                                                                              #
#                                                                              #
#                                                                              #
#                                                                              #
#                                                                              #
#                                                                              #
#                                                                              #
#                                                                              #
#                              X                                               #
#..............................................................................#
#..............................................................................#
#..............................................................................#
#..............................................................................#
#..............................................................................#
#..............................................................................#
#..............................................................................#
#..............................................................................#
#..............................................................................#
#..............................................................................#
#..............................................................................#
#..............................................................................#
#                                #                          X                  #
#                                #                                             #
#                                #                                             #
#                                #                                             #
#                                #                                             S
#                                #                                             #
#                                #                                             #
#                   0           X#X      N                                     #
#                                #                                             #
#                                #                                             #
#                                #                                             #
#                                #                                             #
#                                #                                             #
#                                #                                             #
#                                #                                             #
#                                #                                             #
#                                #                                             #
#                                #                                             #
#                                #                                             #
#                                #               N                             #
#################################################S##############################